{
  "name": "1-3",
  "tileSize": 36,
  "rows": [
    "........................................",
    "........................................",
    "........................................",
    "........................................",
    "........................................",
    "........................................",
    "........................................",
    "........................................",
    ".............C..........................",
    "..........?.###..........Y..............",
    "........................................",
    "..................CCCC..................",
    "..............................T.........",
    "..P..M...E....................T.....F...",
    "GGGGGGGGGGGGGGGGG......GGGGGGGGGGGGGGGGG",
    "GGGGGGGGGGGGGGGGG......GGGGGGGGGGGGGGGGG"
  ]
}