{
  "name": "1-3",
  "tileSize": 36,
  "rows": [
    "............................................",
    "............................................",
    "............................................",
    "............................................",
    "............................................",
    "............................................",
    "............................................",
    "............................................",
    "............................................",
    "............................................",
    "................Y................C..........",
    "................................###.........",
    ".........?............................T.....",
    "..P..CCC....E............W...K........T...F.",
    "GGGGGGGGGGGGGGGGGGG....GGGGGGGGGGGGGGGGGGGGG",
    "GGGGGGGGGGGGGGGGGGG....GGGGGGGGGGGGGGGGGGGGG"
  ]
}