{
  "name": "1-4",
  "tileSize": 36,
  "rows": [
    "..........................................",
    "..........................................",
    "..........................................",
    "..........................................",
    "..........................................",
    "..........................................",
    "...............CC...?U....................",
    "..............####........................",
    "..................Y.......................",
    "......####................................",
    "..........................................",
    "..........................................",
    "................................T.........",
    "..P..W....K...............E.....T.....F...",
    "GGGGGGGGGGGGGGGGGGGGGGGGGGGGGGGGGGGGGGGGGG",
    "GGGGGGGGGGGGGGGGGGGGGGGGGGGGGGGGGGGGGGGGGG"
  ]
}