{
  "name": "1-4",
  "tileSize": 36,
  "rows": [
    "..........................................",
    "..........................................",
    "..........................................",
    "..........................................",
    "..........................................",
    "..........................................",
    "...............CC.........................",
    "..............####........................",
    "..........................................",
    "......####................................",
    "..........................................",
    "..........................................",
    "..........................................",
    "..P.......E.......E.......E...........F...",
    "GGGGGGGGGGGGGGGGGGGGGGGGGGGGGGGGGGGGGGGGGG",
    "GGGGGGGGGGGGGGGGGGGGGGGGGGGGGGGGGGGGGGGGGG"
  ]
}