{
  "name": "1-1",
  "tileSize": 36,
  "rows": [
    "..................................",
    "..................................",
    "..................................",
    "..................................",
    "..................................",
    "..................................",
    "..................................",
    "..................................",
    "..................................",
    "..................................",
    "..................................",
    "..................................",
    "..........?.......................",
    "..P..CCC......E........M..E.CCC.F.",
    "GGGGGGGGGGGGGGGGGG...GGGGGGGGGGGGG",
    "GGGGGGGGGGGGGGGGGG...GGGGGGGGGGGGG"
  ]
}