{
  "name": "1-2",
  "tileSize": 36,
  "rows": [
    "......................................",
    "......................................",
    "......................................",
    "......................................",
    "......................................",
    "......................................",
    "......................................",
    "...............C......................",
    "..............###.....................",
    "........CC............................",
    "........##..................#.........",
    "...........................#..........",
    "..........................#...........",
    "..P...M.....E.........K...........F...",
    "GGGGGGGGGGGGGGGGGGGGGGGGGGGGGGGGGGGGGG",
    "GGGGGGGGGGGGGGGGGGGGGGGGGGGGGGGGGGGGGG"
  ]
}