{
  "name": "1-5",
  "tileSize": 36,
  "rows": [
    "............................................",
    "............................................",
    "............................................",
    "............................................",
    "............................................",
    "............................................",
    "............................................",
    "............................................",
    "............................................",
    "..............?.........U...................",
    "................Y...........................",
    "......C.C.C.C.C.C.C.C.C.C.C.C.C.C...........",
    "..................T...............T.........",
    "..P..W..E...K.....T.E...K...E.....T.....F...",
    "GGGGGGGGGGGGGGGGGGGGGGGGGGGGGGGGGGGGGGGGGGGG",
    "GGGGGGGGGGGGGGGGGGGGGGGGGGGGGGGGGGGGGGGGGGGG"
  ]
}