{
  "name": "1-4",
  "tileSize": 36,
  "rows": [
    "................................................",
    "................................................",
    "................................................",
    "................................................",
    "................................................",
    "................................................",
    "................................................",
    "................................................",
    "................................................",
    "........................Y.......................",
    "................................................",
    "..............................#.................",
    ".........?U..................#..............T...",
    "..P...E.......K.............#..........W..E.T.F.",
    "GGGGGGGGGGGGGGGGGG...GGGGGGGGGGGG...GGGGGGGGGGGG",
    "GGGGGGGGGGGGGGGGGG...GGGGGGGGGGGG...GGGGGGGGGGGG"
  ]
}