{
  "name": "1-3",
  "tileSize": 36,
  "rows": [
    "........................................",
    "........................................",
    "........................................",
    "........................................",
    "........................................",
    "........................................",
    "........................................",
    "........................................",
    ".............C..........................",
    "............###.........................",
    "........................................",
    "..................CCCC..................",
    "........................................",
    "..P......E..................E.......F...",
    "GGGGGGGGGGGGGGGGG......GGGGGGGGGGGGGGGGG",
    "GGGGGGGGGGGGGGGGG......GGGGGGGGGGGGGGGGG"
  ]
}