{
  "name": "1-2",
  "tileSize": 36,
  "rows": [
    "........................................",
    "........................................",
    "........................................",
    "........................................",
    "........................................",
    "........................................",
    "........................................",
    "........................................",
    "........................................",
    "........................................",
    ".........................CCC............",
    ".........................###............",
    "............?..................T........",
    "..P..CC.E.......K..............T..M...F.",
    "GGGGGGGGGGGGGGGGGGGG...GGGGGGGGGGGGGGGGG",
    "GGGGGGGGGGGGGGGGGGGG...GGGGGGGGGGGGGGGGG"
  ]
}