{
  "name": "1-4",
  "tileSize": 36,
  "rows": [
    "..........................................",
    "..........................................",
    "..........................................",
    "..........................................",
    "..........................................",
    "..........................................",
    "...............CC.........................",
    "..............####........................",
    "..................Y.......................",
    "......####................................",
    "..........................................",
    "..........................................",
    "..........................................",
    "..P..W....K...............E...........F...",
    "GGGGGGGGGGGGGGGGGGGGGGGGGGGGGGGGGGGGGGGGGG",
    "GGGGGGGGGGGGGGGGGGGGGGGGGGGGGGGGGGGGGGGGGG"
  ]
}