{
  "name": "1-5",
  "tileSize": 36,
  "rows": [
    "....................................................",
    "....................................................",
    "....................................................",
    "....................................................",
    "....................................................",
    "....................................................",
    "....................................................",
    "....................................................",
    "....................................................",
    ".................Y...................Y..............",
    "....................................................",
    "......C.C.C.C.C.C.C.................................",
    "..........................?U.................T......",
    "..P..W...E...K................K..E...........T.M..F.",
    "GGGGGGGGGGGGGGGGGGGG....GGGGGGGGGGGGGGGG...GGGGGGGGG",
    "GGGGGGGGGGGGGGGGGGGG....GGGGGGGGGGGGGGGG...GGGGGGGGG"
  ]
}