{
  "name": "1-3",
  "tileSize": 36,
  "rows": [
    "........................................",
    "........................................",
    "........................................",
    "........................................",
    "........................................",
    "........................................",
    "........................................",
    "........................................",
    ".............C..........................",
    "............###..........Y..............",
    "........................................",
    "..................CCCC..................",
    "........................................",
    "..P......E..........................F...",
    "GGGGGGGGGGGGGGGGG......GGGGGGGGGGGGGGGGG",
    "GGGGGGGGGGGGGGGGG......GGGGGGGGGGGGGGGGG"
  ]
}