{
  "name": "1-2",
  "tileSize": 36,
  "rows": [
    "......................................",
    "......................................",
    "......................................",
    "......................................",
    "......................................",
    "......................................",
    "......................................",
    "...............C......................",
    "..............###.....................",
    "........CC?U..........................",
    "........##..................#.........",
    "...........................#..........",
    "..........................#...T.......",
    "..P...M.....E.........K.......T...F...",
    "GGGGGGGGGGGGGGGGGGGGGGGGGGGGGGGGGGGGGG",
    "GGGGGGGGGGGGGGGGGGGGGGGGGGGGGGGGGGGGGG"
  ]
}