{
  "name": "1-1",
  "tileSize": 36,
  "rows": [
    "........................................",
    "........................................",
    "........................................",
    "........................................",
    "........................................",
    "........................................",
    "........................................",
    "............CCC.........................",
    "............###.........................",
    "......CC................................",
    ".....####...............................",
    "........................................",
    "..................CCC...................",
    "..P.......E....CC........E...........F..",
    "GGGGGGGGGGGGGGGGGG...GGGGGGGGGGGGGGGGGGG",
    "GGGGGGGGGGGGGGGGGG...GGGGGGGGGGGGGGGGGGG"
  ]
}