{
  "name": "1-5",
  "tileSize": 36,
  "rows": [
    "............................................",
    "............................................",
    "............................................",
    "............................................",
    "............................................",
    "............................................",
    "............................................",
    "............................................",
    "............................................",
    "............................................",
    "......C.C.C.C.C.C.C.C.C.C.C.C.C.C...........",
    "............................................",
    "............................................",
    "..P.....E...E...E...E...E...E...........F...",
    "GGGGGGGGGGGGGGGGGGGGGGGGGGGGGGGGGGGGGGGGGGGG",
    "GGGGGGGGGGGGGGGGGGGGGGGGGGGGGGGGGGGGGGGGGGGG"
  ]
}