{
  "name": "1-5",
  "tileSize": 36,
  "rows": [
    "............................................",
    "............................................",
    "............................................",
    "............................................",
    "............................................",
    "............................................",
    "............................................",
    "............................................",
    "............................................",
    "............................................",
    "................Y...........................",
    "......C.C.C.C.C.C.C.C.C.C.C.C.C.C...........",
    "............................................",
    "..P.....E...K.......E...K...E...........F...",
    "GGGGGGGGGGGGGGGGGGGGGGGGGGGGGGGGGGGGGGGGGGGG",
    "GGGGGGGGGGGGGGGGGGGGGGGGGGGGGGGGGGGGGGGGGGGG"
  ]
}